Record date: 2070-04-23

Stephens Memorial Hospital

Anesthesiology

Preanesthetic Assessment



[REDACTED], M.D.

Associate Medical Director







April 23, 2070



Medical Record Number:  [REDACTED] Victor Lujan



Procedure:  The patient is a [REDACTED] year old male scheduled for AV fistula left forearm.  Surgery is scheduled on [REDACTED].



Chief Complaint & Present Illness:  chronic renal failure secondary to diabetes-[REDACTED] creatinine [REDACTED], BUN [REDACTED], potassium [REDACTED].  Patient has been troubled recently by increasing fatigue and shortness of breath-no PND, but has peripheral edema.



Past Surgical History:  Prior surgery includes:  right shoulder arthroscopy-?  General anesthesia without any known problems; bilateral carpal tunnel release-local; surgery OS for bleeding-local [no old record available but requested]



Family History:  There is no family history of adverse reactions to general anesthesia.



Medications:  [REDACTED], [REDACTED] 100 mg,  [REDACTED] 1.25 mg, [REDACTED] 100 mg, [REDACTED] 10 mg, [REDACTED] 200 mg b.i.d., [REDACTED] 150 mg, insulin NPH 20 units in the a.m. 17 units in the p.m. plus humalog on a sliding scale



Allergies:  [REDACTED] causes convulsions



Social History:

	Smoking:  none

	Alcohol use:  none

	Substance Abuse:  none

	Allergen Exposure within 3 Months(blood products/pregnancy): none



Review of Systems:  



HEENT:  status post recent surgery OS

Cardiovascular:  hypertension; peripheral vascular disease; syncopal episode secondary to antihypertensive medication [Zestril]; atypical chest pain prompted stress test [REDACTED]: Mets equal [REDACTED], negative for ischemia, myocardial scan is normal.  Echo [REDACTED]: EF [REDACTED] percent, RV and LV okay, trace MR, TI, PI. Carotid ultrasounds [REDACTED]-normal.

 Respiratory: patient has noted onset [REDACTED] of cough and chest congestion 

Renal:  present problem 

Hepatobiliary: negative 

Neurological: peripheral neuropathy from knees down to feet bilaterally plus edema; bilateral carpal tunnel 

Gastrointestinal: positive reflux 

Hematological:   anemia-hematocrit [REDACTED], WBC [REDACTED],platelets [REDACTED]  [REDACTED]

Endocrine/metabolic: diabetes for the past [REDACTED]-always on insulin-blood sugar [REDACTED] this a.m.[120-> 200] 

Musculoskeletal/Skin: weakness of hands

Psychiatric: depression-no suicide

Obstetrical:  negative



Vital Signs:



	BP:  [REDACTED]/[REDACTED] mm Hg

	P:  [REDACTED] bpm

	Resp:  [REDACTED] rpm

	SaO2:  [REDACTED]%

	Temp:  [REDACTED] degrees F

	Ht:  [REDACTED] inches

	Wt:  [REDACTED] pounds



Exam:



HEEN&T:  good range of motion, no bruits

Airway:  Mallampatti Class II

Teeth:  none

Lungs:  end expiratory squeaks and wheezes left lung fields 

Heart:  regular rhythm, no murmurs



Assessment:  

ASA Physical Status III-patients will see Dr. Elliott's nurse today for treatment for bronchitis -please check chest film.  Please check old anesthesia record for any problems. 



Plan:



	Proposed Anesthetic: MAC/general anesthesia

	Monitors:  standard

	Pain Management:  PO

	Autologous blood:  none

	Premedication:  none

	Usual Medications:  in a.m. of surgery

	Medications to be held on day of surgery:  no regular insulin

	Diabetic medications:  NPH 10 units-no regular

	NSAIDS:  none

	Aspirin:  none

	NPO: after midnight



Ancillary Studies:  EKG-normal sinus rhythm, LAE.  Chest film pending







________________________________________   

[REDACTED], M.D.